// Maze Scenario with Tiles
//
// Challenge: Navigate through the maze and collect all tiles
//
################
#..............#
#.########..#..#
#.#TT#...#TT#..#
#.#TT#...#TT#..#
#.#..#...####..#
#..............#
#..............#
#.....R........#
################
